Yell - кричати
Guilty - винен (винуватий)
Naughty - збочений
Loathe - ненавидіти
Beyond - За межами
Appalling - жахливо.
Despicable - підлий
Reprehensible - Заслуговує на осуд
Precious - дорогоцінний
Once upon a time - одного разу
Relive - пережити
Except - за винятком
To stroll around - погуляти
Fund-raiser - збір коштів
Excrutiating - допитливий
Bummed - розчарований
Bribe - хабар
Patternal affection - батьківська прихильність
lurch - похитнувся
shindig - вечірка
proclivities - нахили
astute - прозорливий, проникливий
virtue - добродетель
bartender - бармен
entertain - розважати
scribbler - писака, (письменник письменниця напевно)
deceiving - оманливий 
fuss - метушня
sailing along - плив по течії
noble - благородний
curious - допитливий
bum - безхатько, бомж
Intercourse - статевий акт
priest - священик
contributing - сприяння
beg - благати
vessel - судно
aware - усвідомлюю
favor - послуга
concerns - занепокоєння
consider - розглянути
ditch digging - копання канав
are right on the cusp - перебувають на піку, знаходяться на межі 
appreciation - вдячність
ingress - проникнення
busted - попався
decade-plus - більше десяти років.
obsession - одержимість
rehearse - репетирувати
Scorn and desion - презирство та зневагу
ridiculous - безглуздо
deemed a fool - вважали дурнем
intruder - зловмисник
worthy - гідний
coutroom - гардеробна
any excuse to bail - будь-який привід для втечі
perhaps - можливо
scorching - палючий
palely loitering - бліді блукання
stashed up - сховані
damsel in distress - дівчина в біді
cry rape - кричати про зґвалтування
creeps me out - лякає мене
scram - забирайся звідси
throbbing - пульсуючий
get laid - переспати з кимось
nooners - полуденні
delude - обманювати
Partake - скуштувати
banter - жарти
apologize - вибачитися
although - хоча
smoke pot - курити траву
outgrew - переросла(ріс)
sum it up - підбивати підсумки
lame - нездарно, відстійно
poptarts - тістечка
self-indulgent - самозакоханий
bleak - похмурий
trenchant if profane literary criticism - гостра, якщо не сказати профанаційна літературна критика
necessairly - неодмінно
contradictyour - суперечить твоїй
wicked - нечестива
pleasantries - люб'язностям
figured out - з'ясував
tongue - язик
slipped - вислизнув
nut up - збожеволіти
digest dairy - перетравлювати молочні продукти
gastrointestinal tract - шлунково-кишковий тракт
punish - карати
naughty hausfrau - неслухняна господиня
malnutrition - недоїдання
simultaneously exploring - одночасно досліджуючи
guilt - провина
carrying around - носіння з собою
absolved - відпущений
to redemption - до спокути
chunk of change - шматок дріб'язку
custody - опіка
testicles - яєчка
pimp out - сутенерство
wallowing - занурення
despair - відчай
bonded - невільний
compromise involved - компроміс
practicalities - практичні аспекти
ivory tower - вежа зі слонової кістки
sreening room - сортувальна кімната
invite me over - запроси мене до себе
haute cuisine - висока кухня
blood related - кровна спорідненість
considerable - значна
maimed you - покалічив тебе.
leaned - нахилився
srewing up - зростаючий
goofy - кумедний
attendants - супроводжуючі
sin - гріх 
somersaults - сальто
terrific - приголомшливо
hooker - повія
gratis - безкоштовно
doubt - сумніватися
determine - визначати
bladders - сечові міхури
funeral - похорон
rectum - пряма кишка
prolapsed - опущена
charismatic - харизматичний
overcrowded - переповнений
cripple - каліка
opportunity - можливість
rendered - надана
partook - брав участь
mutt - шавка 
eyesore - більмо на очах
whiny - скиглій
hysterical - істеричка
shrink - психіатр
liberties - свободи
pelvis - таз 
grind - шліфування
prolonged absence - тривала відсутність
sundae - морозиво
ridiculous - безглуздий
punish - карати
earlyish - ранній
sudden - раптовий
stick with it - дотримуватися
disappear - зникати
perhaps - можливо
marital discord - подружні розбіжності
recline - відкинутися
split up - розлучатися
knee-rattling - брязкання колінами
grieving - скорботний
piece of crap - шматок лайна
sublime - піднесений
clause - пункт
wad of cash - пачка грошей
reap the benefits - пожинати плоди
intend - мати намір
screenplay - сценарій
unwittingly - мимоволі
underage - неповнолітній
ensue - випливати
jinks - приколи
pecked - клюнуло
staggering - приголомшливий
hostile - ворожий
browsing - перегляд
finest - найкращий
shiny - блискучий
bummer - облом
offspring - нащадок
involved - задіяний
affairs - справи
intrusive - нав'язливий
confession - сповідь
bothered - стурбований
whimsical - примхливий
appropriate - відповідний
convinced - переконаний
dorm - гуртожиток
kudos - похвально
teat - соска
lay it to me - розкажи мені
shreds - шматки
forefront - передній край
regret it - шкодую про це.